22 22 22 22 22 22 22 22 22 22 22 22 22 22 22 21
22 22 22 22 22 22 22 22 22 22 22 22 22 22 22 21
22 22 22 22 22 22 22 22 22 22 22 22 22 22 22 21
22 22 12 22 22 22 22 22 22 22 22 22 22 22 22 21
22 12 12 12 22 22 22 22 41 41 41 22 22 22 22 21
22 12 12 12 12 12 32 32 41 41 41 32 32 32 32 31
12 12 12 32 32 32 32 32 41 41 41 32 32 32 32 31
12 12 32 32 32 32 32 32 41 41 41 32 32 32 32 31
12 12 32 32 32 32 32 32 41 41 41 32 32 32 32 31
32 32 32 32 32 12 12 12 41 41 41 12 12 12 32 31
32 32 32 32 32 12 12 12 12 12 12 12 12 12 12 11
32 32 32 32 12 12 12 12 12 12 12 12 12 12 12 11
32 32 12 12 12 12 12 12 12 12 12 12 12 12 12 11
12 12 12 12 12 12 12 12 12 12 12 12 12 12 12 11
12 12 12 12 12 12 12 12 12 12 12 12 12 12 12 11
10 10 10 10 10 10 10 10 10 10 10 10 10 10 10 10
